22
8
#################E###
#                   #
#   #################
#         #         #
#      #            #
#################   #
#                   #
###S#################
