15
8
#############E#
#    # # #    #
# ##   # # ####
# #  ###      #
# # #    # #  #
# # ######  # #
# #         # #
#S#############
